Afghanistan - af
Aland Islands - ax
Albania - al
Algeria - dz
American Samoa - as
Andorra - ad
Angola - ao
Anguilla - ai
Antarctica - aq
Antigua and Barbuda - ag
Argentina - ar
Armenia - am
Aruba - aw
Australia - au
Austria - at
Azerbaijan - az
Bahamas - bs
Bahrain - bh
Bangladesh - bd
Barbados - bb
Belarus - by
Belgium - be
Belize - bz
Benin - bj
Bermuda - bm
Bhutan - bt
Bolivia - bo
Bosnia and Herzegovina - ba
Botswana - bw
Bouvet Island - bv
Brazil - br
British Indian Ocean Territory - io
Brunei Darussalam - bn
Bulgaria - bg
Burkina Faso - bf
Burundi - bi
Cambodia - kh
Cameroon - cm
Canada - ca
Cape Verde - cv
Cayman Islands - ky
Central African Republic - cf
Chad - td
Chile - cl
China - cn
Christmas Island - cx
Cocos (Keeling) Islands - cc
Colombia - co
Comoros - km
Congo - cg
Congo, Democratic Republic of - cd
Cook Islands - ck
Costa Rica - cr
Cote D'Ivoire - ci
Croatia - hr
Cyprus - cy
Czech Republic - cz
Denmark - dk
Djibouti - dj
Dominica - dm
Dominican Republic - do
East Timor - tmp
Ecuador - ec
Egypt - eg
El Salvador - sv
England - eng
Equatorial Guinea - gq
Eritrea - er
Estonia - ee
Ethiopia - et
Faroe Islands - fo
Faukland Islands - fk
Fiji - fj
Finland - fi
France - fr
French Guyana - gf
French Polynesia - pf
French Southern Territories - tf
Gabon - ga
Gambia - gm
Georgia - ge
Germany - de
Ghana - gh
Gibraltar - gi
Greece - gr
Greenland - gl
Grenada - gd
Guadeloupe - gp
Guam - gu
Guatemala - gt
Guernsey - gg
Guinea - gn
Guinea-Bissau - gw
Guyana - gy
Haiti - ht
Heard and McDonald Islands - hm
Honduras - hn
Hong Kong - hk
Hungary - hu
Iceland - is
India - in
Indonesia - id
Iraq - iq
Ireland - ie
Isle of Man - im
Israel - il
Italy - it
Jamaica - jm
Japan - jp
Jersey - je
Jordan - jo
Kazakhstan - kz
Kenya - ke
Kiribati - ki
Kuwait - kw
Kyrgyzstan - kg
Laos - la
Latvia - lv
Lebanon - lb
Lesotho - ls
Liberia - lr
Libya - ly
Liechtenstein - li
Lithuania - lt
Luxembourg - lu
Macao - mo
Macedonia - mk
Madagascar - mg
Malawi - mw
Malaysia - my
Maldives - mv
Mali - ml
Malta - mt
Marshall Islands - mh
Martinique - mq
Mauritania - mr
Mauritius - mu
Mayotte - yt
Mexico - mx
Micronesia - fm
Moldova - md
Monaco - mc
Mongolia - mn
Montenegro - me
Montserrat - ms
Morocco - ma
Mozambique - mz
Myanmar - mm
Namibia - na
Nauru - nr
Nepal - np
Netherlands - nl
Netherlands Antilles - an
Neutral Zone - unavailable
New Caledonia - nc
New Zealand - nz
Nicaragua - ni
Niger - ne
Nigeria - ng
Niue - nu
Norfolk Island - nf
Northern Ireland - nir
Northern Mariana Islands - mp
Norway - no
Oman - om
Pakistan - pk
Palau - pw
Palestinian Territory, Occupied - ps
Panama - pa
Papua New Guinea - pg
Paraguay - py
Peru - pe
Philippines - ph
Pitcairn - pn
Poland - pl
Portugal - pt
Puerto Rico - pr
Qatar - qa
Reunion - re
Romania - ro
Russian Federation - ru
Rwanda - rw
Saint Barthelemy - bl
Saint Helena - sh
Saint Kitts and Nevis - kn
Saint Lucia - lc
Saint Martin - mf
Saint Pierre and Miquelon - pm
Saint Vincent & the Grenadines - vc
Samoa - ws
San Marino - sm
Sao Tome and Principe - st
Saudi Arabia - sa
Scotland - sct
Senegal - sn
Serbia - rs
Seychelles - sc
Sierra Leone - sl
Singapore - sg
Slovakia - sk
Slovenia - si
Solomon Islands - sb
Somalia - so
South Africa - za
South Georgia & S. Sandwich Is. - gs
South Korea - kr
Spain - es
Sri Lanka - lk
Suriname - sr
Svalbard and Jan Mayen - sj
Swaziland - sz
Sweden - se
Switzerland - ch
Taiwan - tw
Tajikistan - tj
Tanzania - tz
Thailand - th
Togo - tg
Tokelau - tk
Tonga - to
Trinidad and Tobago - tt
Tunisia - tn
Turkey - tr
Turkmenistan - tm
Turks and Caicos Islands - tc
Tuvalu - tv
Uganda - ug
Ukraine - ua
United Arab Emirates - ae
United Kingdom - gb
United States - us
United States Minor Outlying Is. - um
Uruguay - uy
Uzbekistan - uz
Vanuatu - vu
Vatican City State - va
Venezuela - ve
Viet Nam - vn
Virgin Islands, British - vg
Virgin Islands, U.S. - vi
Wales - unavailable
Wallis and Futuna - wf
Western Sahara - eh
Yemen - ye
Zambia - zm
Zimbabwe - zw 